wwwwwwwwwwwwww
w     p      w
w c           w
w            w
w          c  w
w     e      w
w            w
w         c   w
wwwwwwdwwwwwww